NO     ./path_to_the_north_texture
SO ./path_to_the_south_texture
WE ./path_to_the_west_texture
EA ./path_to_the_eat_texture
C           222,222,2
F 220,100,     0

11111111111


111111111111