NO ./imgs/north_texture.xpm
SO ./imgs/south_texture.xpm
F 00,153,1
WE ./imgs/west_texture.xpm
EA ./imgs/east_texture.xpm


C 255,255,255

1111111
1000001
1000001
1000001
1000001
1000001
1000001
1000001
100N001
1111111