NO ./imgs/north_texture.xpm
SO ./imgs/south_texture.xpm
F 0,128,128
WE ./imgs/west_texture.xpm
EA ./imgs/east_texture.xpm


C 255,255,0

1111111
1000001
1000001
1000001
1001001
101N101
1001001
1000001
1000001
1111111