NO ./validatefile
SO ./validatefile
F 123,123,1
WE ./validatefile
C 111,112,111

EA ./validatefile

1111 1111111111
1001 1000000001
10S1 1001000001
111111111111111

